11111111111
100000000E1
10P00001111
10000000001
10000000C01
10000000001
10000000001
10000000001
10000000001
10000000001
11111111111