1111111111111111111111111111
100000000E1000000C001C000001
10P0000111100000000010000001
10000000000000000F0011111011
10000000C0000000011110000001
1000000000000000010C00000001
100000F000000000010011111101
1000000000000000010010000001
1000C00000000000010010001111
10000000000000000000100000C1
1111111111111111111111111111