11111111111
10000000C01
10P00000001
10000000001
10000000E01
10000000001
10000000001
10000000001
10000000001
10000000001
11111111111