111111111111111111111
100000000E10000000001
10P000011110000000001
100000000000000000001
10000000C000000001111
100000000000000001001
100000000000000001001
100000000000000001001
100000000000000001001
100000000000000000001
111111111111111111111
