1111111111111111111111111111
1000F0000E1000000C001C000001
10P0000111100000000010000001
100F0000000000000F0011111011
10000000C0000000011110000001
1000000000000F00010C00000001
100000F000000000010011111101
1000000000000000010010000001
1000C0000000F000010010001111
10000000000000000000100000C1
1111111111110111111111111111
1C00000000000000000000000001
1111111111111111111111111111